85
4

7
9 2
9 10
2 10
2 6
4 6
4 4
7 4

9
9 2
9 6
6 6
6 10
2 10
2 6
4 6
4 4
7 4

7
9 2
9 10
2 10
2 2
5 2
5 4
7 4

9
9 2
9 6
6 6
6 10
2 10
2 2
5 2
5 4
7 4

12 13
0 0 0 0 0 0 0 0 0 0 4 4
0 0 4 4 4 4 0 0 0 0 0 4
0 4 1 1 1 1 4 4 0 2 0 0
0 4 1 4 4 1 4 4 4 1 0 0
4 4 1 4 1 1 1 3 4 1 0 0 
4 4 1 4 1 4 4 4 4 1 4 0
0 4 1 1 1 4 1 1 1 1 4 4
0 0 1 4 0 0 1 0 4 1 4 0
0 4 1 4 0 4 1 4 4 1 0 0
0 4 1 0 4 4 1 4 4 1 0 0
4 4 1 1 1 1 1 1 1 1 0 0
0 4 4 4 4 4 4 4 4 4 0 0
0 0 0 0 0 4 4 4 0 0 0 0