94
4

13
6 12
2 12
2 9
5 9
5 6
8 6
8 4
11 4
11 10
14 10
14 8
18 8
18 4

11
6 12
2 12
2 9
5 9
5 6
8 6
8 4
14 4
14 8
18 8
18 4

13
6 12
2 12
2 9
5 9
5 6
8 6
8 10
11 10
11 4
14 4
14 8
18 8
18 4

11
6 12
2 12
2 9
5 9
5 6
8 6
8 10
14 10
14 8
18 8
18 4

20 18
0 0 0 0 0 0 0 0 0 0 0 0 0 0 0 0 0 4 4 0
0 0 0 0 0 0 0 0 0 4 4 0 0 0 0 4 4 4 4 4
0 0 0 0 0 0 0 0 0 4 4 4 4 0 0 0 4 4 0 0
0 0 4 4 4 4 4 0 0 0 4 4 4 4 4 0 0 0 0 0
0 0 0 4 4 4 4 4 1 1 1 1 1 1 1 4 0 0 3 0
0 0 0 0 0 4 4 4 1 0 0 1 4 4 1 4 4 0 1 0
0 0 0 0 0 1 1 1 1 4 0 1 4 4 1 4 4 4 1 0
0 0 0 4 4 1 0 4 1 4 4 1 0 0 1 4 4 4 1 0
0 0 4 4 4 1 0 4 1 4 4 1 4 4 1 1 1 1 1 4
0 4 1 1 1 1 0 0 1 4 4 1 4 4 1 0 0 4 4 4
4 4 1 4 4 4 0 0 1 1 1 1 1 1 1 4 0 0 0 0
4 4 1 4 4 0 0 0 0 0 4 4 4 4 4 4 4 0 0 0
4 4 1 1 1 1 2 0 0 0 0 0 0 4 4 4 4 0 0 0
0 4 4 4 0 0 0 4 4 0 0 0 0 0 0 4 4 0 0 0
0 4 4 4 0 0 4 4 4 4 4 0 0 0 0 0 0 0 4 0
0 0 4 0 0 4 4 4 4 4 4 4 0 0 4 4 4 4 4 0
0 0 0 0 0 0 0 4 4 4 4 4 4 0 0 4 4 4 0 0
0 0 0 0 0 0 0 0 0 0 4 4 0 0 0 0 0 0 0 0