87
1

8
4 4
6 4
6 1
5 1
1 1
1 7
9 7
9 1

11 9
0 4 4 4 4 4 4 0 0 0 0
4 1 1 1 1 1 1 4 0 3 4
4 1 4 4 4 4 1 4 0 1 4
4 1 4 0 0 4 1 4 4 1 4
4 1 0 0 2 1 1 4 4 1 4
4 1 4 0 0 4 4 0 4 1 4
4 1 4 4 0 0 0 4 4 1 4
4 1 1 1 1 1 1 1 1 1 4
0 4 4 4 4 4 4 4 4 4 0