90
3

8
3 11
1 11
1 1
6 1
6 11
11 11
11 1
9 1

12
3 11
1 11
1 1
6 1
6 5
7 5
7 7
6 7
6 11
11 11
11 1
9 1

12
3 11
1 11
1 1
6 1
6 5
5 5
5 7
6 7
6 11
11 11
11 1
9 1

13 13
0 4 4 4 4 4 0 0 0 0 4 4 0
4 1 1 1 1 1 1 0 0 3 1 1 4
4 1 0 0 0 4 1 4 0 0 0 1 4
4 1 0 4 4 4 1 4 4 4 0 1 4
4 1 0 4 4 4 1 4 4 4 0 1 4
4 1 0 4 4 1 1 1 4 4 0 1 4
4 1 0 4 4 1 1 1 4 4 0 1 4
4 1 0 4 4 1 1 1 4 4 0 1 4
4 1 0 4 4 4 1 4 4 4 0 1 4
4 1 0 4 4 4 1 4 4 4 0 1 4
4 1 0 0 0 4 1 4 0 0 0 1 4
4 1 1 2 0 0 1 1 1 1 1 1 4
0 4 4 0 0 0 0 4 4 4 4 4 0