89
1

12
10 4
10 14
6 14
6 10
8 10
8 8
4 8
4 6
6 6
6 2
2 2
2 12

13 17
0 4 4 4 0 0 0 0 0 0 0 0 0
4 4 4 4 4 4 0 0 0 0 0 0 0
4 4 1 1 1 1 1 0 0 0 0 0 0
4 4 1 4 4 4 1 0 0 0 0 0 0
0 4 1 4 4 4 1 0 0 0 2 0 0
0 4 1 4 4 4 1 0 0 0 1 0 0
0 0 1 4 1 1 1 4 0 0 1 0 0
0 0 1 4 1 4 4 4 4 0 1 0 0
0 0 1 4 1 1 1 1 1 4 1 0 0
0 0 1 0 4 4 4 4 1 4 1 0 0
0 0 1 0 0 4 1 1 1 4 1 0 0
0 0 1 0 0 0 1 4 4 4 1 4 0
0 0 3 0 0 0 1 4 4 4 1 4 0
0 0 0 0 0 0 1 4 4 4 1 4 4
0 0 0 0 0 0 1 1 1 1 1 4 4
0 0 0 0 0 0 0 4 4 4 4 4 4
0 0 0 0 0 0 0 0 0 4 4 4 0