100
2

9
14 14
0 14
0 0
10 0
10 10
4 10
4 4
6 4
6 6

10
14 14
14 0
12 0
12 12
2 12
2 2
8 2
8 8
6 8
6 6

15 15
1 1 1 1 1 1 1 1 1 1 1 0 1 1 1
1 4 4 4 4 4 4 4 4 4 1 0 1 4 1
1 4 1 1 1 1 1 1 1 4 1 0 1 4 1
1 4 1 0 0 0 0 0 1 4 1 0 1 4 1
1 4 1 0 1 1 1 0 1 4 1 0 1 4 1
1 4 1 0 1 4 1 0 1 4 1 0 1 4 1
1 4 1 0 1 4 3 0 1 4 1 0 1 4 1
1 4 1 0 1 4 1 0 1 4 1 0 1 4 1
1 4 1 0 1 4 1 1 1 4 1 0 1 4 1
1 4 1 0 1 4 4 4 4 4 1 0 1 4 1
1 4 1 0 1 1 1 1 1 1 1 0 1 4 1
1 4 1 0 0 0 0 0 0 0 0 0 1 4 1
1 4 1 1 1 1 1 1 1 1 1 1 1 4 1
1 4 4 4 4 4 4 4 4 4 4 4 4 4 1
1 1 1 1 1 1 1 1 1 1 1 1 1 1 2