90
1

50
8 4
7 4
7 3
5 3
5 4
4 4
4 5
3 5
3 6
2 6
2 8
3 8
3 9
4 9
4 10
5 10
5 11
7 11
7 10
8 10
8 9
9 9
9 8
10 8
10 7
11 7
11 6
12 6
12 5
13 5
13 4
14 4
14 3
16 3
16 4
17 4
17 5
18 5
18 6
19 6
19 8
18 8
18 9
17 9
17 10
16 10
16 11
14 11
14 10
13 10

22 15
0 0 0 0 0 0 0 0 0 0 0 0 0 0 0 4 0 0 0 0 0 0
0 0 0 0 0 0 4 0 0 0 0 0 0 0 4 4 4 0 0 0 0 0
0 0 0 0 0 4 4 4 0 0 0 0 0 4 4 4 4 4 0 0 0 0
0 0 0 0 4 1 1 1 4 0 0 0 4 4 1 1 1 4 4 0 0 0
0 0 0 4 1 1 4 1 2 4 0 4 4 1 1 4 1 1 4 4 0 0
0 0 4 1 1 4 0 4 4 0 4 4 1 1 4 4 4 1 1 4 4 0
0 4 1 1 4 0 0 0 0 4 4 1 1 4 4 0 0 4 1 1 4 4
4 4 1 4 0 0 0 0 4 4 1 1 4 4 0 0 0 0 4 1 4 4
4 4 1 1 4 0 0 4 4 1 1 4 4 0 0 0 0 4 1 1 4 0
0 4 4 1 1 4 4 4 1 1 4 4 0 4 4 0 4 1 1 4 0 0 
0 0 4 4 1 1 4 1 1 4 4 0 4 3 1 4 1 1 4 0 0 0
0 0 0 4 4 1 1 1 4 4 0 0 0 4 1 1 1 4 0 0 0 0
0 0 0 0 4 4 4 4 4 0 0 0 0 0 4 4 4 0 0 0 0 0
0 0 0 0 0 4 4 4 0 0 0 0 0 0 0 4 0 0 0 0 0 0
0 0 0 0 0 0 4 0 0 0 0 0 0 0 0 0 0 0 0 0 0 0