81
1

8
6 1
1 1
1 6
4 6
4 4
8 4
8 9
2 9

10 11
0 0 4 4 4 4 0 0 0 0
0 1 1 1 1 1 2 0 0 0
4 1 4 0 0 0 0 0 0 0
4 1 0 0 0 4 4 4 0 0
4 1 4 0 1 1 1 1 1 0
4 1 4 4 1 4 4 4 1 4
0 1 1 1 1 0 4 4 1 4
0 0 4 4 0 0 4 4 1 4
0 0 0 0 0 4 4 4 1 4
0 0 3 1 1 1 1 1 1 0
0 0 0 4 4 4 4 4 0 0