70
6
1 0
1 5
5 5
5 1
8 1
8 5

11 9
0 4 4 4 4 4 4 0 0 0 0
4 1 1 1 1 1 1 4 0 3 4
4 1 4 4 4 4 1 4 0 1 4
4 1 4 0 0 4 1 4 4 1 4
4 1 0 0 2 1 1 4 4 1 4
4 1 4 0 0 4 4 0 4 1 4
4 1 4 4 0 0 0 4 4 1 4
4 1 1 1 1 1 1 1 1 1 4
0 4 4 4 4 4 4 4 4 4 0