92
2

8
7 5
9 5
9 2
2 2
2 11
6 11
6 14
15 14

9
7 5
5 5
5 8
9 8
9 11
12 11
12 2
15 2
15 14

18 17
0 0 4 4 4 4 4 4 4 4 0 4 4 4 4 4 0 0
0 0 0 0 0 0 4 0 0 0 0 0 0 0 4 0 0 0
4 0 1 1 1 1 1 1 1 1 0 0 1 1 1 1 0 4
4 0 1 4 4 4 4 4 4 1 0 0 1 4 4 1 0 4
4 0 1 4 4 4 4 4 4 1 4 4 1 4 4 1 4 4
4 0 1 4 4 1 1 2 1 1 0 0 1 4 4 1 0 4
4 0 1 4 4 1 0 0 4 0 0 0 1 4 4 1 0 4
4 0 1 4 4 1 0 0 4 0 0 0 1 4 4 1 0 4
4 4 1 4 4 1 1 1 1 1 0 0 1 4 4 1 0 0
4 0 1 4 4 4 4 4 4 1 4 4 1 4 4 1 0 4
4 0 1 4 4 4 4 4 4 1 0 0 1 4 4 1 4 4
4 0 1 1 1 1 1 4 4 1 1 1 1 4 4 1 0 4
0 0 0 0 4 0 1 4 4 4 4 4 4 4 4 1 0 4
0 0 4 4 4 0 1 4 4 4 4 4 4 4 4 1 0 4
0 0 0 0 4 0 1 1 1 1 1 1 1 1 1 3 0 4
0 0 0 0 0 0 0 0 0 0 4 0 0 0 0 0 0 0
0 0 0 0 0 0 4 4 4 4 4 4 4 4 4 4 0 0