105
3

25
5 16
5 18
3 18
3 14
9 14
9 18
11 18
11 12
7 12
7 10
5 10
5 12
3 12
3 8
1 8
1 6
11 6
11 10
13 10
13 4
6 4
6 1
8 1
8 2
16 2

21
5 16
5 18
3 18
3 14
9 14
9 18
11 18
11 12
7 12
7 10
9 10
9 6
11 6
11 10
13 10
13 4
6 4
6 1
8 1
8 2
16 2

19
5 16
5 18
3 18
3 14
9 14
9 20
13 20
13 14
17 14
17 7
15 7
15 10
13 10
13 4
6 4
6 1
8 1
8 2
16 2

19 22
0 0 0 0 0 0 4 4 4 4 4 4 0 0 0 0 0 0 0
0 0 0 0 0 4 1 1 1 4 4 4 4 4 4 0 0 0 0
0 0 0 0 0 4 1 4 1 1 1 1 1 1 1 1 3 0 0
0 0 0 0 0 4 1 4 4 4 4 4 4 4 4 4 0 0 0
0 0 0 0 0 4 1 1 1 1 1 1 1 1 4 4 4 0 0
0 0 0 4 4 4 4 4 4 4 4 4 4 1 4 4 4 0 0
0 1 1 1 1 1 1 1 1 1 1 1 4 1 4 4 4 0 0
4 1 4 4 4 4 4 4 4 1 4 1 4 1 4 1 1 1 0
4 1 1 1 4 4 4 4 4 1 4 1 4 1 4 1 4 1 0
4 4 4 1 4 4 4 4 4 1 4 1 4 1 4 1 4 1 0
0 4 4 1 4 1 1 1 1 1 4 1 1 1 1 1 4 1 4
0 0 4 1 4 1 4 1 4 4 4 4 4 4 4 4 4 1 4
0 0 4 1 1 1 4 1 1 1 1 1 4 4 4 4 4 1 4
0 0 4 4 4 4 4 4 4 4 4 1 4 4 4 4 4 1 4
0 0 4 1 1 1 1 1 1 1 4 1 4 1 1 1 1 1 0
0 0 4 1 4 4 4 4 4 1 4 1 4 1 4 4 4 0 0
0 0 4 1 4 2 4 4 4 1 4 1 4 1 4 4 0 0 0
0 0 4 1 4 1 4 4 4 1 4 1 4 1 4 4 0 0 0
0 0 0 1 1 1 4 4 4 1 1 1 4 1 4 0 0 0 0
0 0 0 4 4 4 4 4 4 1 4 4 4 1 0 0 0 0 0
0 0 0 0 0 0 0 4 4 1 1 1 1 1 0 0 0 0 0
0 0 0 0 0 0 0 0 0 0 4 4 4 0 0 0 0 0 0