70
6
1 0
1 5
5 5
5 1
8 1
8 5

20 18
0 0 0 0 0 0 0 0 0 0 0 0 0 0 0 0 0 4 4 0
0 0 0 0 0 0 0 0 0 4 4 0 0 0 0 4 4 4 4 4
0 0 0 0 0 0 0 0 0 4 4 4 4 0 0 0 4 4 0 0
0 0 4 4 4 4 4 0 0 0 4 4 4 4 4 0 0 0 0 0
0 0 0 4 4 4 4 4 1 1 1 1 1 1 1 4 0 0 3 0
0 0 0 0 0 4 4 4 1 0 0 1 4 4 1 4 4 0 1 0
0 0 0 0 0 1 1 1 1 4 0 1 4 4 1 4 4 4 1 0
0 0 0 4 4 1 0 4 1 4 4 1 0 0 1 4 4 4 1 0
0 0 4 4 4 1 0 4 1 4 4 1 4 4 1 1 1 1 1 4
0 4 1 1 1 1 0 0 1 4 4 1 4 4 1 0 0 4 4 4
4 4 1 4 4 4 0 0 1 1 1 1 1 1 1 4 0 0 0 0
4 4 1 4 4 0 0 0 0 0 4 4 4 4 4 4 4 0 0 0
4 4 1 1 1 1 2 0 0 0 0 0 0 4 4 4 4 0 0 0
0 4 4 4 0 0 0 4 4 0 0 0 0 0 0 4 4 0 0 0
0 4 4 4 0 0 4 4 4 4 4 0 0 0 0 0 0 0 4 0
0 0 4 0 0 4 4 4 4 4 4 4 0 0 4 4 4 4 4 0
0 0 0 0 0 0 0 4 4 4 4 4 4 0 0 4 4 4 0 0
0 0 0 0 0 0 0 0 0 0 4 4 0 0 0 0 0 0 0 0