70
2

18
3 3
3 6
0 6
0 12
3 12
3 9
6 9
6 12
9 12
9 9
12 9
12 6
9 6
9 3
12 3
12 0
6 0
6 6

16
3 3
3 6
0 6
0 12
3 12
3 9
6 9
6 12
12 12
12 6
9 6
9 3
12 3
12 0
6 0
6 6

13 13
0 0 0 0 0 0 1 1 1 1 1 1 1
0 0 0 0 0 4 1 4 4 0 0 4 1
0 0 0 0 4 4 1 4 0 0 4 4 1
0 0 0 2 4 4 1 0 0 1 1 1 1
0 0 4 1 4 4 1 0 4 1 4 4 0
0 4 4 1 4 0 1 4 4 1 4 0 0
1 1 1 1 0 0 3 4 4 1 1 1 1
1 4 4 0 0 4 4 4 4 0 0 4 1
1 4 0 0 4 4 4 4 0 0 4 4 1
1 0 0 1 1 1 1 0 0 1 1 1 1
1 0 4 1 4 4 1 0 4 1 4 4 1
1 4 4 1 4 0 1 4 4 1 4 0 1
1 1 1 1 0 0 1 1 1 1 1 1 1
