100
1

11
3 7
3 18
15 18
15 11
11 11
11 14
7 14
7 3
15 3
15 7
11 7

19 22
0 0 0 0 0 0 0 0 0 0 0 4 0 0 0 0 0 0 0
0 0 0 0 0 0 0 0 0 4 4 4 0 0 0 0 0 4 4
0 0 0 0 0 0 0 4 4 4 4 0 0 0 0 4 4 4 0
0 0 0 0 0 0 4 1 1 1 1 1 1 1 1 1 4 4 0
0 0 0 0 0 4 4 1 4 0 0 0 0 4 4 1 4 0 0
0 0 0 0 0 4 4 1 4 0 0 0 4 4 4 1 0 0 0
0 0 0 0 4 4 4 1 0 0 0 4 4 4 4 1 0 0 0
0 0 0 2 4 4 4 1 0 0 4 3 1 1 1 1 0 0 0
0 0 0 1 4 4 4 1 0 4 4 4 4 4 0 0 0 0 0
0 0 4 1 4 4 0 1 4 4 4 4 0 0 0 4 4 0 0
0 0 4 1 4 4 0 1 4 4 0 0 0 4 4 4 0 0 0
0 4 4 1 4 0 0 1 0 0 0 1 1 1 1 1 0 0 0
0 4 4 1 4 0 0 1 0 4 4 1 4 4 4 1 0 0 4
4 4 4 1 0 0 4 1 4 4 4 1 4 4 0 1 0 4 4
4 4 0 1 0 4 4 1 1 1 1 1 4 0 0 1 4 4 0
4 0 0 1 0 4 4 4 4 4 4 4 0 0 4 1 4 4 0
0 0 0 1 4 4 4 4 4 0 0 0 0 4 4 1 4 0 0
0 0 4 1 4 4 4 0 0 0 0 0 4 4 4 1 0 0 0
0 0 4 1 1 1 1 1 1 1 1 1 1 1 1 1 0 0 0
0 4 4 4 0 0 0 0 0 0 4 4 4 4 0 0 0 0 0
0 0 0 0 0 0 0 0 0 4 4 4 0 0 0 0 0 0 0
0 0 0 0 0 0 0 0 4 4 0 0 0 0 0 0 0 0 0