70
6

11
1 1
4 1
4 4
3 4
3 8
7 8
7 10
4 10
4 14
2 14
2 17

11
1 1
4 1
4 4
3 4
3 8
7 8
7 10
9 10
9 14
2 14
2 17

11
1 1
4 1
4 4
8 4
8 7
7 7
7 10
4 10
4 14
2 14
2 17

11
1 1
4 1
4 4
8 4
8 7
7 7
7 10
9 10
9 14
2 14
2 17

13
1 1
4 1
4 4
8 4
8 7
12 7
12 11
9 11
9 10
4 10
4 14
2 14
2 17

11
1 1
4 1
4 4
8 4
8 7
12 7
12 11
9 11
9 14
2 14
2 17

14 19
4 4 4 4 4 4 0 0 0 0 0 0 0 0
4 2 1 1 1 4 0 0 0 0 0 0 0 0
4 4 4 4 1 4 0 0 0 0 0 0 0 0
0 0 4 4 1 4 4 4 4 4 0 0 0 0
0 0 4 1 1 1 1 1 1 4 0 0 0 0
0 0 4 1 4 4 4 4 1 4 0 0 0 0
0 0 4 1 4 4 4 4 1 4 4 4 4 4
0 0 4 1 4 4 4 1 1 1 1 1 1 4
0 0 4 1 1 1 1 1 4 4 4 4 1 4
0 0 4 4 4 4 4 1 4 4 4 4 1 4
0 0 0 4 1 1 1 1 1 1 4 4 1 4
0 0 0 4 1 4 4 4 4 1 1 1 1 4
0 0 0 4 1 4 4 4 4 1 4 4 4 4
0 4 4 4 1 4 4 4 4 1 4 0 0 0
0 4 1 1 1 1 1 1 1 1 4 0 0 0
0 4 1 4 4 4 4 4 4 4 4 0 0 0
0 4 1 4 0 0 0 0 0 0 0 0 0 0
0 4 3 4 0 0 0 0 0 0 0 0 0 0
0 4 4 4 0 0 0 0 0 0 0 0 0 0