70
6
1 0
1 5
5 5
5 1
8 1
8 5

18 17
0 0 4 4 4 4 4 4 4 4 0 4 4 4 4 4 0 0
0 0 0 0 0 0 4 0 0 0 0 0 0 0 4 0 0 0
4 0 1 1 1 1 1 1 1 1 0 0 1 1 1 1 0 4
4 0 1 4 4 4 4 4 4 1 0 0 1 4 4 1 0 4
4 0 1 4 4 4 4 4 4 1 4 4 1 4 4 1 4 4
4 0 1 4 4 1 1 2 1 1 0 0 1 4 4 1 0 4
4 0 1 4 4 1 0 0 4 0 0 0 1 4 4 1 0 4
4 0 1 4 4 1 0 0 4 0 0 0 1 4 4 1 0 4
4 4 1 4 4 1 1 1 1 1 0 0 1 4 4 1 0 0
4 0 1 4 4 4 4 4 4 1 4 4 1 4 4 1 0 4
4 0 1 4 4 4 4 4 4 1 0 0 1 4 4 1 4 4
4 0 1 1 1 1 1 4 4 1 1 1 1 4 4 1 0 4
0 0 0 0 4 0 1 4 4 4 4 4 4 4 4 1 0 4
0 0 4 4 4 0 1 4 4 4 4 4 4 4 4 1 0 4
0 0 0 0 4 0 1 1 1 1 1 1 1 1 1 3 0 4
0 0 0 0 0 0 0 0 0 0 4 0 0 0 0 0 0 0
0 0 0 0 0 0 4 4 4 4 4 4 4 4 4 4 0 0