110
2

12
8 4
0 4
0 2
8 2
8 0
14 0
14 6
16 6
16 2
26 2
26 4
18 4

12
8 4
0 4
0 6
10 6
10 2
12 2
12 8
18 8
18 6
26 6
26 4
18 4

27 9
0 0 0 0 0 0 0 0 1 1 1 1 1 1 1 0 0 0 0 0 0 0 0 0 0 0 0
0 0 0 0 0 0 0 0 1 4 4 4 4 4 1 0 0 0 0 0 0 0 0 0 0 0 0
1 1 1 1 1 1 1 1 1 4 1 1 1 4 1 4 1 1 1 1 1 1 1 1 1 1 1
1 4 4 4 4 4 4 4 4 4 1 4 1 4 1 4 1 4 4 4 4 4 4 4 4 4 1
1 1 1 1 1 1 1 1 2 4 1 4 1 4 1 4 1 4 3 1 1 1 1 1 1 1 1
1 4 4 4 4 4 4 4 4 4 1 4 1 4 1 4 1 4 4 4 4 4 4 4 4 4 1
1 1 1 1 1 1 1 1 1 1 1 4 1 4 1 1 1 4 1 1 1 1 1 1 1 1 1
0 0 0 0 0 0 0 0 0 0 0 0 1 4 4 4 4 4 1 0 0 0 0 0 0 0 0
0 0 0 0 0 0 0 0 0 0 0 0 1 1 1 1 1 1 1 0 0 0 0 0 0 0 0