70
6
1 0
1 5
5 5
5 1
8 1
8 5

14 19
4 4 4 4 4 4 0 0 0 0 0 0 0 0
4 2 1 1 1 4 0 0 0 0 0 0 0 0
4 4 4 4 1 4 0 0 0 0 0 0 0 0
0 0 4 4 1 4 4 4 4 4 0 0 0 0
0 0 4 1 1 1 1 1 1 4 0 0 0 0
0 0 4 1 4 4 4 4 1 4 0 0 0 0
0 0 4 1 4 4 4 4 1 4 4 4 4 4
0 0 4 1 4 4 4 1 1 1 1 1 1 4
0 0 4 1 1 1 1 1 4 4 4 4 1 4
0 0 4 4 4 4 4 1 4 4 4 4 1 4
0 0 0 4 1 1 1 1 1 1 4 4 1 4
0 0 0 4 1 4 4 4 4 1 1 1 1 4
0 0 0 4 1 4 4 4 4 1 4 4 4 4
0 4 4 4 1 4 4 4 4 1 4 0 0 0
0 4 1 1 1 1 1 1 1 1 4 0 0 0
0 4 1 4 4 4 4 4 4 4 4 0 0 0
0 4 1 4 0 0 0 0 0 0 0 0 0 0
0 4 3 4 0 0 0 0 0 0 0 0 0 0
0 4 4 4 0 0 0 0 0 0 0 0 0 0