90
4

20
2 14
4 14
4 12
2 12
2 10
6 10
6 13
13 13
13 8
8 8
8 5
3 5
3 3
10 3
10 6
14 6
14 4
12 4
12 2
14 2

21
2 14
4 14
4 12
2 12
2 10
6 10
6 13
13 13
13 11
8 11
8 8
8 5
3 5
3 3
10 3
10 6
14 6
14 4
12 4
12 2
14 2

20
2 14
4 14
4 12
2 12
2 10
6 10
6 13
13 13
13 11
8 11
8 8
3 8
3 3
10 3
10 6
14 6
14 4
12 4
12 2
14 2

19
2 14
4 14
4 12
2 12
2 10
6 10
6 13
13 13
13 8
3 8
3 5
3 3
10 3
10 6
14 6
14 4
12 4
12 2
14 2

17 17
0 0 0 4 4 4 4 4 0 0 0 0 0 0 0 0 0
0 4 4 4 4 4 0 0 0 0 0 0 0 0 0 0 0
0 4 4 4 4 0 0 0 0 0 0 0 1 1 3 0 0
4 4 4 1 1 1 1 1 1 1 1 4 1 4 0 0 0
4 4 4 1 0 0 0 0 0 4 1 4 1 1 1 0 0
4 4 0 1 1 1 1 1 1 4 1 4 4 4 1 0 0
4 0 0 1 0 0 0 4 1 4 1 1 1 1 1 0 0
4 0 0 1 0 0 4 4 1 4 4 4 4 0 0 0 0
0 0 0 1 1 1 1 1 1 1 1 1 1 1 0 0 0
0 0 0 0 4 4 4 4 1 4 4 0 0 1 0 0 4
0 0 1 1 1 1 1 4 1 4 0 0 0 1 0 0 4
0 0 1 4 4 4 1 4 1 1 1 1 1 1 0 4 4 
0 0 1 1 1 4 1 4 0 0 0 0 0 1 4 4 4 
0 0 0 4 1 4 1 1 1 1 1 1 1 1 4 4 4
0 0 2 1 1 0 0 0 0 0 0 0 4 4 4 4 0
0 0 0 0 0 0 0 0 0 0 0 4 4 4 4 4 0 
0 0 0 0 0 0 0 0 0 4 4 4 4 4 0 0 0