70
2

8
3 10
3 6
1 6
1 1
6 1
6 8
9 8
9 10

10
3 10
3 6
1 6
1 1
6 1
6 4
10 4
10 8
9 8
9 10


12 11
0 0 4 4 4 0 0 0 0 0 0 0
0 1 1 1 1 1 1 4 0 0 0 0
0 1 0 4 4 4 1 4 4 4 0 0
4 1 0 0 4 4 1 4 4 4 4 0
4 1 4 0 0 4 1 1 1 1 1 4
4 1 4 4 0 4 1 0 4 4 1 4
0 1 1 1 0 0 1 4 0 4 1 4
0 4 4 1 4 0 1 4 4 0 1 0
0 0 4 1 4 0 1 1 1 1 1 0
0 0 0 1 4 0 0 4 4 1 4 0
0 0 0 2 0 0 0 0 0 3 0 0